s---------|||---------||||-------L
L-|--|----|||---------||||-------L
L---------|||---------||||-------L
L--|------|||---------||||-------L
L-|--|----|||---------||||-------L
L---------|||---------||||-------L
L--|------|||---------||||-------L
L--|------|||---------||||-------L
L-|--|----|||---------||||-------L
L---------|||---------||||-------L
L--|------|||---------||||-------L
L--|------|||---------||||-------L
L-|--|----|||---------||||-------L
L---------|||---------||||-------L
L--|------|||---------||||-------L
L--|------|||---------||||-------L
L-|--|----|||---------||||-------L
L---------|||---------||||-------L
L--|------|||---------||||-------L
L--|------|||---------||||-------L
L-|--|----|||---------||||-------L
L---------|||---------||||-------L
L--|------|||---------||||-------L
L--|------|||---------||||-------L
L-|--|----|||---------||||-------L
L---------|||---------||||-------L
L--|------|||---------||||-------g

